      R 1920       1080 


EA ./data/img/gaben3.xpm

S                     ./data/img/barrel.xpm
F    105 ,105,105
C    169  , 169 , 169

WE ./data/img/gaben2.xpm



NO ./data/img/gaben4.xpm

SO       ./data/img/gaben.xpm

11111
10201
10001
10001
11111
11111
10201
10001
10001
101111111111111111111    
1000100000111111110001       
1020100000000000000201       
1000100000101111110001       
1101111111101000011111       
1101000000101000000011       
1101000000001010000011       
1101000000100000000011
1111111111111011111111
1111111111111011111111
110111111120200111111111111111
110000000000000000000000000021
110111110120210001110111111111
1100000001101100000101       
1100000000100000000101       
1100000000101000000101       
11111000001010000011011       
10001111111010000010001       
1020000000000000010201       
10001111111211111110001       
10111111111211111111111 
101111111111111111111111111111
1011111111111111111111111111111111111111
1E222222222222222222221
10111111111011111111111
1000000000101
1000000000101
1000000000101
1000000000101
10000000001011
1000000000101
1000000000101
1000000000101
1000020000001
1111101111111
    111
111
101
101
101
101
101
101
101
101
101
101
101
101
101
101
101
101
101
101
101
101
101
101
101
101
101
101
101
101
101
101
101
101
101
101
101
101
101
101
101
101
101
101
101
101
101
101
101
101
101
101
101
101
101
101
101
101
101
101
101
101
101
101
101
101
101
101
101
101
101
101
101
101
101
101
101
101
101
101
101
101
101
101
101
101
101
101
101
101
101
101
101
101
101
101
101
101
101
101
101
101
101
101
101
101
101
101
101
101
101
101
101
101
101
101
101
101
101
101
101
101
101
101
101
101
101
101
101
101
101
101
101
101
101
101
101
101
101
101
101
101
101
101
101
101
101
101
101
101
101
101
101
101
101
101
101
101
101
101
101
101
101
101
101
101
101
101
101
101
101
101
101
101
101
101
101
101
101
101
101
101
101
101
101
101
101
101
101
101
101
101
101
101
101
101
101
101
101
101
101
101
101
101
101
101
101
101
101
101
101
101
101
101
101
101
101
101
101
101
101
101
101
101
101
101
101
101
101
101
101
101
101
101
101
101
111